54
10
WWWWWWWWWWWWWWWWWWWWWWWWWWWWWWWWWWWWWWWWWWWW
WOOOOOOOOOOOOOOOOOOOOOOOOO..................WWWWWWWWWW
W...........OOOOOOOOOOOOOOOOOOOOOOOOOOOOOOOOOOOOOOOOW
WOOOOOOOOOOOOOOOOOOOOOOOOOOOOOOOOOOOOOOOOOOOOOOWWWWW
WWWWWWOOOOOOOOOOOOOOOOOOOOOOOOOOOOOOOOOOOOOOOOOW
     W..................WWWWWWWOOOOOOOOOOOOOOOOW
     W..................WWWWWWWWWWWWWWWWWWWWWWWW
     W........OOOOOOOOO.W
     W..................W
     WWWWWWWWWWWWWWWWWWWW
